1111111111
1000P00001
1111111111