1111111111
1X00P0C0E1
1111111111