1111111111
1000P0C0E1
1111111111