1111111111111111111111
10000C10111011101X1111
1010101111111110101011
1000000P00000000001111
111111101111101X111011
1111111011101010001011
1000111011111C10111011
1C10101011111110101011
1110111010001C10111011
1C00000C101010000000E1
1111111111111111111111